###########
#@..k..E..#
#..##..#..#
#..P..#...#
###########